2 2
0 0
1 2
11111111111111111111111111111111
11111111111111111111111111111111
11000000000000011000000000000011
11000000000000011000000000000011
11000000000000011000000000000011
11000000000000000000000000000011
11000000000000000000000000000011
11000000000000011000000000000011
11000000000000011000000000000011
11000000000000011000000000000011
11000000000000011000000000000011
11111110011111111111111100111111
11111110011111111111111100111111
11000000000000011000000000000011
11000000000000011000000000000011
11000000000000011000000000000011
11000000000000011000000000000011
11000000000000000000000000000011
11000000000000000000000000000011
11000000000000011000000000000011
11000000000000011000000000000011
11000000000000011000000000000011
11111111111111111111111111111111
11111111111111111111111111111111
