4 4
1 1
0 1 1
1111111111111111111111111111111111111111111111111111111111111111
1111111111111111111111111111111111111111111111111111111111111111
1100000000000001100000000000000110000000000000011000000000000011
1100000000000001100000000000000110000000000000011000000000000011
1100000000000001100000000000000110000000000000011000000000000011
1100000000000000000000000000000000000000000000000000000000000011
1100000000000000000000000000000000000000000000000000000000000011
1100000000000000000000000000000000000000000000000000000000000011
1100000000000001100000000000000110000000000000011000000000000011
1100000000000001100000000000000110000000000000011000000000000011
1100000000000001100000000000000110000000000000011000000000000011
1111111000111111111111100011111111111100011111111111110001111111
1111111000111111111111100011111111111100011111111111110001111111
1100000000000001100000000000000110000000000000011000000000000011
1100000000000001100000000000000110000000000000011000000000000011
1100000000000001100000000000000110000000000000011000000000000011
1100000000000000000000000000000110000000000000000000000000000011
1100000000000000000000000000000000000000000000000000000000000011
1100000000000000000000000000000000000000000000000000000000000011
1100000000000001100000000000000000000000000000011000000000000011
1100000000000001100000000000000110000000000000011000000000000011
1100000000000001100000000000000110000000000000011000000000000011
1100000000000001100000000000000110000000000000011000000000000011
1111111000111111111111000111111111111110001111111111110001111111
1111111000111111111111000111111111111110001111111111110001111111
1100000000000001100000000000000110000000000000011000000000000011
1100000000000001100000000000000110000000000000011000000000000011
1100000000000001100000000000000110000000000000011000000000000011
1100000000000001100000000000000000000000000000011000000000000011
1100000000000000000000000000000000000000000000000000000000000011
1100000000000000000000000000000000000000000000000000000000000011
1100000000000000000000000000000110000000000000000000000000000011
1100000000000001100000000000000110000000000000011000000000000011
1100000000000001100000000000000110000000000000011000000000000011
1100000000000001100000000000000110000000000000011000000000000011
1111111000111111111111100011111111111100011111111111110001111111
1111111000111111111111100011111111111100011111111111110001111111
1100000000000001100000000000000110000000000000011000000000000011
1100000000000001100000000000000110000000000000011000000000000011
1100000000000001100000000000000110000000000000011000000000000011
1100000000000000000000000000000000000000000000000000000000000011
1100000000000000000000000000000000000000000000000000000000000011
1100000000000000000000000000000000000000000000000000000000000011
1100000000000001100000000000000110000000000000011000000000000011
1100000000000001100000000000000110000000000000011000000000000011
1100000000000001100000000000000110000000000000011000000000000011
1111111111111111111111111111111111111111111111111111111111111111
1111111111111111111111111111111111111111111111111111111111111111
